tofp.vhd	to_fp
tofp-b.vhd	to_fp behavioral
tofpt.vhd	to_fp_test
tofpt-b.vhd	to_fp_test bench

tovec.vhd	to_vector
tovec-b.vhd	to_vector behavioral
tovect.vhd	to_vector_test
tovect-b.vhd	to_vector_test bench

mac.vhd	mac
mac-b.vhd	mac behavioral

mact.vhd	mac_test
mact-bb.vhd	mac_test bench_behavioral

reg.vhd	reg
reg-b.vhd	reg behavioral

mult.vhd	multiplier
mult-b.vhd	multiplier behavioral
multt.vhd	multiplier_test
multt-b.vhd	multiplier_test bench

pas.vhd	product_adder_subtracter
pas-b.vhd	product_adder_subtracter behavioral

acca.vhd	accumulator_adder
acca-b.vhd	accumulator_adder behavioral

accr.vhd	accumulator_reg
accr-b.vhd	accumulator_reg behavioral

srff.vhd	synch_sr_ff
srff-b.vhd	synch_sr_ff behavioral

ovfl.vhd	overflow_logic
ovfl-b.vhd	overflow_logic behavioral

mac-r.vhd	mac rtl

mact-br.vhd	mac_test bench_rtl
mact-bv.vhd	mac_test bench_verify
